30
17
111111111111111111111111111111
100000000000000000000000000001
100000000000000000000000000001
100000000000000000000000000001
100000000000000000000000000001
100000000000000000000000000001
100000000000000000000000000001
100000000000000000000000000001
100000000000000000000000000001
100000000000000000000000000001
100000000000000000000000000001
100000000000000000000000000001
100000000000000000000000000001
100000000000000000003333330001
100000000000002000000000000001
100000000000003000003333330001
111111111111111111111111111111
11
101
512
896
101
896
896
101
0
896
101
0
768
101
0
576
101
0
448
101
0
320
101
0
192
101
0
64
100
1280
832
100
1472
832
