58
30
1111111000000000000000000000000000000000000000000000000000
1110000000000020000000020000000000000000000200000000200000
0000000000000011111111110000000000000000000111111111100000
0200000200200000000000000000002000002002000000000000000000
1111111111110000000000000000011111111111100000000000000000
0000000000000000002002000020000000000000000000020020000200
0002000000200200011111111111000020000002002000111111111110
1111111111111110000020002000011111111111111100000200020000
0000000000000000011111111111000000000000000000111111111110
0000000000000000000000000000000000000000000000000000000000
0000000000000000000000000000000000000000000000000000000000
0000000000000000000000000000000000000000000000000000000000
0000000000000000000000000000000000000000000000000000000000
0020200020000222020020000220200000000000000000000000000000
1111111111111111111111111111100000000000000000000000000000
0000000000000000000000000000000000000000000000000000000000
0000000000000020000000020000000000000000000000000000000000
0000000000000011000011110000000000000000000000000000000000
0200000200200000000100000000000000000000000000000000000000
1111111111110000001000000000000000000000000000000000000000
0000000000000000012002000020000000000000000000000000000000
0002000000200000111111111111000000000000000000000000000000
1111111111110001000020002000000000000000000000000000000000
0000000000000010011111111111000000000000000000000000000000
0000000000000100000000000000000000000000000000000000000000
0000000000001000000000000000000000000000000000000000000000
0000000000010000000000000000000000000000000000000000000000
0000000000100000000000000000000000000000000000000000000000
0020200021000222020024330220200000000000000000000000000030
4444444444444444111111111111111111111111111111111111111113
0