30
17
5,0,0,0,0,0,0,0,0,0,0,0,0,0,0,0,0,0,0,0,0,0,0,0,0,0,0,0,0,6,
5,0,0,0,0,0,0,0,0,0,0,0,0,0,0,0,0,0,0,0,0,0,0,0,0,0,0,0,0,6,
5,0,0,0,0,0,0,0,0,0,0,0,0,0,0,0,0,0,0,0,0,0,0,0,0,0,0,0,0,6,
5,0,0,0,0,0,0,0,0,0,0,0,0,0,0,0,0,0,0,0,0,0,0,0,0,0,0,0,0,6,
5,0,0,0,0,0,0,0,0,0,0,0,0,0,0,0,0,0,0,0,0,0,0,0,0,0,0,0,0,6,
5,0,0,0,0,0,0,0,0,2,4,8,0,0,0,0,0,0,0,0,0,0,0,0,0,0,0,0,0,6,
5,0,0,0,0,0,0,0,0,0,0,0,0,0,0,0,2,4,4,4,4,4,4,4,4,4,4,4,4,17,
15,4,4,8,0,0,0,0,0,0,0,0,0,0,0,0,0,0,0,0,0,0,0,0,0,0,0,0,0,6,
5,0,0,0,0,0,0,0,0,0,0,0,0,0,0,0,0,0,0,0,0,0,0,0,0,0,0,0,0,6,
5,0,0,0,0,0,0,0,0,0,0,0,0,0,0,0,0,0,0,0,0,0,0,0,0,0,0,0,0,6,
5,0,0,0,2,4,8,0,0,0,0,0,0,0,0,0,0,0,0,0,0,0,0,0,0,0,0,0,0,6,
5,0,0,0,0,0,0,0,0,0,0,0,0,0,0,0,0,0,0,0,0,0,0,0,0,0,0,0,0,6,
15,4,4,4,4,4,4,4,4,4,4,4,4,4,4,4,4,8,0,0,0,0,0,0,0,0,0,0,0,6,
5,0,0,0,0,0,0,0,0,0,0,0,0,0,0,0,0,0,2,4,4,4,4,8,0,0,0,0,0,6,
5,0,0,0,0,0,0,0,0,0,0,0,0,0,0,0,0,0,0,0,0,0,0,0,0,0,0,0,0,6,
5,0,0,0,0,0,0,0,0,0,0,0,7,0,0,0,0,0,0,0,0,0,0,0,0,0,0,0,0,6,
11,1,1,1,1,1,1,1,1,1,1,1,14,1,1,1,1,1,1,1,1,1,1,1,1,1,1,1,1,10,
2
Artifact 1.1.2
3001
1216
704
Artifact 1.1.1
3000
64
640
29
2000
64
832
2006
1024
896
2007
1344
704
2007
512
640
2007
1728
256
2750
1664
192
2001
320
960
2001
64
960
2002
576
960
2001
1024
960
2002
1280
960
2001
1344
960
2001
1408
960
2002
1664
960
2001
1408
768
2001
896
704
2002
832
704
2001
384
704
2001
128
704
2002
64
704
2001
320
576
2002
128
384
2001
640
256
2002
1088
320
2001
1280
320
2006
640
640
2006
64
320
2006
1536
256
2006
1792
896
