30
51
5,0,0,0,0,0,0,0,0,0,0,0,0,0,0,0,0,0,0,0,0,0,0,0,0,0,0,0,0,6,
5,0,0,0,0,0,0,0,0,0,0,0,0,0,0,0,0,0,0,0,0,0,0,0,0,0,0,0,0,6,
5,0,0,0,0,0,0,0,0,0,0,0,0,0,0,0,0,0,0,0,0,0,0,0,0,0,0,0,0,6,
5,0,0,0,0,0,0,0,0,0,0,2,4,4,4,4,4,8,0,0,0,0,0,0,0,0,0,0,0,6,
5,0,0,0,0,0,0,0,0,0,0,0,0,0,0,0,0,0,0,0,0,0,0,0,0,0,0,0,0,6,
15,4,4,4,4,4,4,4,28,0,0,0,0,0,0,0,0,0,0,0,27,4,4,4,4,4,4,4,4,17,
5,0,0,0,0,0,0,0,31,0,0,0,0,0,0,0,0,0,0,0,31,0,0,0,0,0,0,0,0,6,
5,0,0,0,0,0,0,0,31,0,0,0,0,0,0,0,0,0,0,0,31,0,0,0,0,0,0,0,0,6,
5,0,0,0,0,0,0,0,31,0,0,0,0,0,0,0,0,0,0,0,31,0,0,0,0,0,0,0,0,6,
15,4,4,4,4,4,4,4,29,0,0,0,0,0,0,0,0,0,0,0,30,4,4,4,4,4,4,4,4,17,
5,0,0,0,0,0,0,0,0,0,0,0,23,3,3,3,24,0,0,0,0,0,0,0,0,0,0,0,0,6,
5,0,0,0,0,0,0,0,0,0,0,0,26,33,33,33,25,0,0,0,0,0,0,0,0,0,0,0,0,6,
5,0,0,0,0,0,0,0,0,0,0,0,0,0,0,0,0,0,0,0,0,0,0,0,0,0,0,0,0,6,
5,0,0,0,0,0,0,0,0,0,0,0,0,0,0,0,0,0,0,0,0,0,0,0,0,0,0,0,0,6,
5,0,0,0,0,0,0,0,0,32,0,0,0,0,0,0,0,0,0,32,0,0,0,0,0,0,0,0,0,6,
5,0,0,0,0,0,0,0,0,0,0,0,0,0,0,0,0,0,0,0,0,0,0,0,0,0,0,0,0,6,
5,0,0,0,0,0,0,0,0,0,0,0,0,0,0,0,0,0,0,0,0,0,0,0,0,0,0,0,0,6,
5,0,2,4,8,0,0,0,0,0,0,0,0,0,0,0,0,0,0,0,0,0,0,0,0,2,4,8,0,6,
5,0,0,0,0,0,0,0,0,0,0,0,0,0,0,0,0,0,0,0,0,0,0,0,0,0,0,0,0,26,
5,0,0,0,0,0,0,0,0,0,0,0,0,0,0,0,0,0,0,0,0,0,0,0,0,0,0,0,0,0,
5,0,0,0,0,0,0,0,0,0,0,2,4,4,4,4,4,8,0,0,0,0,0,0,0,0,0,0,0,0,
5,0,0,0,0,0,0,0,0,0,0,0,0,0,0,0,0,0,0,0,0,0,0,0,0,0,0,0,0,0,
5,0,0,0,0,0,0,0,0,0,0,0,0,0,0,0,0,0,0,0,0,0,0,0,0,0,0,0,0,0,
25,0,0,0,0,0,2,4,4,4,4,4,4,4,4,4,4,4,4,4,4,4,8,0,0,0,0,0,0,0,
0,0,0,0,0,0,0,0,0,0,0,0,0,0,0,0,0,0,0,0,0,0,0,0,0,0,0,0,0,23,
0,0,0,0,0,0,0,0,0,0,0,0,0,0,0,0,0,0,0,0,0,0,0,0,0,0,0,0,0,6,
0,0,0,0,32,0,0,0,0,0,0,0,0,0,0,0,0,0,0,0,0,0,0,0,32,0,0,0,0,6,
0,0,0,0,0,0,0,0,0,0,0,0,0,0,0,0,0,0,0,0,0,0,0,0,0,0,0,0,0,6,
0,0,0,0,0,0,27,4,4,8,0,0,7,0,0,0,7,0,0,2,4,4,28,0,0,0,0,0,0,26,
0,0,0,0,0,0,31,0,0,0,0,0,31,0,0,0,31,0,0,0,0,0,31,0,0,0,0,0,0,0,
0,0,0,0,0,0,31,0,32,0,0,0,31,0,0,0,31,0,0,0,32,0,31,0,0,0,0,0,0,0,
24,0,0,0,0,0,22,0,0,0,0,0,31,32,0,32,31,0,0,0,0,0,22,0,0,0,0,0,0,23,
5,0,0,0,0,0,0,0,0,0,0,0,30,4,4,4,29,0,0,0,0,0,0,0,0,0,0,0,0,6,
5,0,0,0,0,0,0,0,0,0,0,0,0,0,0,0,0,0,0,0,0,0,0,0,0,0,0,0,0,6,
5,0,0,0,0,0,0,0,0,0,0,32,0,0,0,0,0,32,0,0,0,0,0,0,0,0,0,0,0,6,
5,0,0,0,0,0,0,0,0,0,0,0,0,0,0,0,0,0,0,0,0,0,0,0,0,0,0,0,0,6,
5,0,2,4,4,4,4,8,0,0,0,0,0,0,0,0,0,0,0,0,0,2,4,4,4,4,8,0,0,6,
5,0,0,0,0,0,0,0,0,0,0,0,0,0,0,0,0,0,0,0,0,0,0,0,0,0,0,0,0,6,
5,0,0,0,0,0,0,0,0,0,2,4,4,4,4,4,4,4,8,0,0,0,0,0,0,0,0,0,0,6,
25,0,0,0,0,0,0,0,0,0,0,0,0,0,0,0,0,0,0,0,0,0,0,0,0,0,0,0,0,26,
0,0,0,32,0,0,0,0,0,0,0,0,0,0,0,0,0,0,0,0,0,0,0,0,0,0,32,0,0,0,
0,0,0,0,0,0,0,0,0,0,0,0,0,0,0,0,0,0,0,0,0,0,0,0,0,0,0,0,0,0,
24,0,0,0,0,0,0,0,0,0,0,0,0,0,0,0,0,0,0,0,0,0,0,0,0,0,0,0,0,23,
5,0,0,0,0,0,32,0,0,0,0,0,0,0,0,0,0,0,0,0,0,0,0,0,32,0,0,0,0,6,
5,0,0,0,0,0,0,0,0,0,0,0,0,0,0,0,0,0,0,0,0,0,0,0,0,0,0,0,0,6,
5,0,0,0,0,0,0,0,0,0,0,0,0,27,4,28,0,0,0,0,0,0,0,0,0,0,0,0,0,6,
5,0,0,0,2,4,4,4,4,8,0,0,0,31,0,31,0,0,0,0,2,4,4,4,4,4,8,0,0,6,
5,0,0,0,0,0,0,0,0,0,0,0,0,31,0,31,0,0,0,0,0,0,0,0,0,0,0,0,0,6,
15,8,0,0,0,0,0,0,0,0,0,0,0,22,0,22,0,0,0,0,0,0,0,0,0,0,0,0,2,17,
5,0,0,0,0,0,0,0,0,0,0,0,0,0,0,0,0,0,0,0,0,0,0,0,0,0,0,0,0,6,
11,1,1,1,1,1,1,1,1,1,1,1,1,24,0,23,1,1,1,1,1,1,1,1,1,1,1,1,1,10,
2
Artifact 1.3.2
3007
896
3136
Artifact 1.3.1
3006
896
1984
46
2000
832
2688
2011
384
2880
2011
1536
2880
2011
832
1920
2011
960
1920
2011
896
2368
2011
256
2240
2011
1536
2240
2006
1664
3072
2008
896
3136
2003
384
2688
2003
768
1728
2003
1024
2368
2011
640
1408
2011
1024
1216
2011
192
1024
2011
1024
576
2011
1856
1472
2011
1472
256
2009
512
256
2009
576
832
2003
832
1408
2003
384
2240
2002
128
3136
2002
192
3136
2002
256
3136
2002
1408
3136
2002
1472
3136
2002
832
2368
2002
768
2368
2002
448
1728
2002
512
1728
2002
832
1216
2002
832
576
2002
128
512
2002
192
512
2007
256
448
2006
1216
768
2003
1472
512
2003
320
512
2003
64
512
2003
768
1408
2003
896
1408
2003
1344
1728
2003
1664
2496
2752
896
64
