40
40
1111111111111111111111111111111111111111
1000000000000000000000000000000000000001
1000000000000000000000000000000000000001
1000000000000000000000000000000000000001
1000000000000000000000000000000000000001
1000000000000000000000000000000000000001
1000000000000000000000000000000000000001
1000000000000000000000000000000000000001
1000000000000000000000000000000000000001
1000000000000000000000000000000000000001
1000000000000000000000000000000000000001
1000000000000000000000000000000000000001
1000000000000000000000000000000000000001
1000000000000000000000000000000000000001
1000000000000000000000000000000000000001
1000000000000000000000000000000000000001
1000000000000000000000000000000000000001
1000000000000000000000000000000000000001
1000000000000000000000000000000000000001
1000000000000000000000000000000000000001
1000000000000000000000000000000000000001
1000000000000000000000000000000000000001
1000000010000001000000000000000000000001
1000000010000001000000000000000000000001
1000000010000001000000000000000000000001
1000000010000001000000000000000000000001
1000000010000001000000000000000000000001
1000010010000001000000000000000000000001
1000100010000001000000000000000000000001
1001000010000001000000000000000000000001
1010000010000001000000000000000000000001
1000000010000001000000000000000000000001
1000000010000001000000000000000000000001
1100000010000001000000000000000000000001
1010000010000001000000000000000000000001
1001000010000001000000000000000010000001
1000100010000001000000000000000000000001
1000000000000001000000001000000000000001
1000000000000001000000001000000010000001
1111111111111111111111111111111111111111
0
