60
25
0,0,0,0,0,0,0,0,0,0,0,0,0,0,0,0,0,0,0,0,31,0,0,0,0,0,0,0,0,0,0,0,0,0,0,31,0,0,0,0,0,0,0,31,0,0,0,0,0,0,0,0,0,0,0,0,0,0,0,0,
0,0,0,0,0,0,0,0,0,0,0,0,0,7,0,0,0,0,0,0,31,0,0,0,0,0,0,0,0,0,0,0,0,0,0,31,0,0,0,0,0,0,0,31,0,0,0,0,0,0,0,0,0,0,0,0,0,0,0,0,
0,0,0,0,0,0,0,0,0,0,0,0,0,31,0,0,0,0,0,0,31,0,0,0,0,0,0,0,0,0,0,0,0,0,0,31,0,0,0,7,0,0,0,22,0,0,0,0,0,0,0,0,0,0,0,0,2,4,4,4,
0,0,0,0,0,0,0,0,0,0,0,0,0,31,0,0,0,0,0,0,31,0,0,0,0,0,0,0,0,0,0,0,0,0,0,22,0,0,0,31,0,0,0,0,0,0,0,0,2,4,4,4,4,4,8,0,0,0,0,0,
0,0,0,0,0,0,0,0,0,0,0,0,2,36,0,0,0,0,0,2,36,0,0,0,0,0,0,0,0,0,0,0,0,0,0,0,0,0,0,31,0,0,0,0,0,0,0,0,0,0,0,0,0,0,0,0,0,0,0,0,
0,0,0,0,0,0,0,0,0,0,0,0,0,31,0,0,0,0,0,0,22,0,0,0,0,0,0,0,0,0,0,0,0,0,0,0,0,0,0,31,0,0,0,7,0,0,0,0,0,0,0,0,0,0,0,0,0,0,0,0,
0,0,0,0,0,0,0,0,0,0,0,0,0,34,8,0,0,0,0,0,0,0,0,0,0,0,0,0,0,0,0,0,0,0,0,7,0,0,0,31,0,0,2,36,0,0,0,0,0,0,0,0,0,0,0,0,0,0,0,0,
4,4,4,4,8,0,0,0,0,0,0,0,0,22,0,0,0,0,0,0,0,0,0,0,0,0,0,0,0,0,0,0,0,0,0,31,0,0,0,22,0,0,0,31,0,0,0,0,0,0,0,0,0,0,0,0,0,0,0,0,
0,0,0,0,0,0,0,0,0,0,0,0,0,0,0,0,0,0,0,0,0,0,0,0,0,0,0,0,0,0,0,0,0,0,0,31,0,0,0,0,0,0,0,31,0,0,0,0,0,0,0,0,0,0,0,0,0,0,0,0,
0,0,0,0,0,0,0,0,0,0,0,0,0,0,0,0,0,0,0,0,0,0,0,0,0,0,0,0,0,0,0,7,0,0,0,31,0,0,0,0,0,0,0,31,0,0,0,0,0,0,0,0,0,0,0,0,0,0,0,0,
0,0,0,0,0,0,0,0,0,0,0,0,0,0,0,0,0,0,0,0,0,0,0,2,4,4,4,4,8,0,0,31,0,0,0,31,0,0,0,7,0,0,2,36,0,0,0,7,0,0,0,0,0,0,0,0,0,0,0,0,
0,0,0,0,0,0,0,0,0,0,0,0,0,0,0,0,0,0,0,0,0,0,0,0,0,0,0,0,0,0,0,31,0,0,0,31,0,0,0,31,0,0,0,31,0,0,0,31,0,0,0,0,0,0,0,0,0,0,0,0,
0,0,0,0,0,0,0,0,0,0,0,0,0,0,0,0,0,0,0,0,0,0,0,0,0,0,0,0,0,0,0,31,0,0,0,31,0,0,0,31,0,0,0,31,0,0,0,31,0,0,0,0,0,0,0,0,0,0,0,0,
0,0,0,0,0,0,0,0,0,0,0,0,0,0,0,0,0,0,0,0,0,0,0,0,0,0,0,0,0,0,0,31,0,0,0,31,0,0,0,31,0,0,0,31,0,0,0,31,0,0,0,0,0,0,0,0,0,0,0,0,
0,0,0,0,0,0,0,0,0,0,0,0,0,0,0,0,0,0,0,0,0,0,0,0,0,0,0,0,0,0,0,34,4,4,4,37,4,4,4,37,4,4,4,37,4,4,4,36,0,0,0,0,0,0,0,0,0,0,0,0,
0,0,0,0,0,0,0,0,0,0,0,0,0,0,0,0,0,0,0,2,4,4,4,8,0,0,0,0,0,0,0,22,0,0,0,0,0,0,0,0,0,0,0,0,0,0,0,31,0,0,0,0,0,0,0,0,0,0,0,0,
0,0,0,0,0,0,0,0,0,0,0,0,0,0,0,0,0,0,0,0,0,0,0,0,0,0,0,0,0,0,0,0,0,0,0,0,0,0,0,0,0,0,0,0,0,0,0,31,0,0,0,0,0,0,0,0,0,0,0,0,
0,0,0,0,0,0,0,0,0,0,0,0,0,0,0,0,0,0,0,0,0,0,0,0,0,0,0,0,0,0,0,0,0,0,0,0,0,0,0,0,0,0,0,0,0,0,0,31,0,0,0,0,0,0,0,0,0,0,0,0,
0,0,0,0,0,0,0,0,0,0,0,0,0,0,0,0,0,0,0,0,0,0,0,0,0,0,0,0,0,0,0,0,0,2,4,8,0,0,0,0,0,0,0,0,0,0,0,31,0,0,0,0,0,0,0,0,0,0,0,0,
0,0,0,0,0,0,0,0,0,2,4,4,4,4,8,0,0,0,0,0,0,0,0,0,0,0,0,0,0,0,0,0,0,0,0,0,0,0,0,0,0,0,0,0,0,0,0,22,0,0,0,0,0,0,0,0,0,0,0,0,
0,0,0,0,0,0,0,0,0,0,0,0,0,0,0,0,0,0,0,0,0,0,0,0,0,0,0,0,0,0,0,0,0,0,0,0,0,0,0,0,0,0,0,0,0,0,0,0,0,0,0,0,0,0,0,0,0,0,0,0,
0,0,0,0,0,0,0,0,0,0,0,0,0,0,0,0,0,0,0,0,0,0,0,0,0,0,0,0,0,0,0,0,0,0,0,0,32,0,0,0,0,0,0,0,0,0,0,0,0,0,0,0,0,0,0,0,0,0,0,0,
0,0,0,0,0,0,0,0,0,0,0,0,0,0,0,0,0,0,0,0,0,0,0,0,0,0,0,0,0,0,0,0,0,0,0,0,0,0,0,0,0,0,0,0,0,0,0,0,0,0,0,0,0,0,0,0,0,0,0,0,
0,0,0,0,0,0,0,0,0,0,0,0,0,0,0,0,0,0,0,0,0,0,0,0,0,0,0,0,0,0,0,0,0,0,0,0,0,0,0,0,0,0,0,0,0,0,0,0,0,0,0,0,0,0,0,0,0,0,0,0,
3,3,3,3,3,3,3,3,3,3,3,3,3,3,3,3,24,0,0,0,0,0,0,0,0,0,0,0,0,0,0,23,3,3,3,3,3,3,3,3,3,3,3,3,3,3,3,24,0,0,0,0,0,0,0,0,0,23,3,3,
3
Artifact 1.9.1
3023
64
320
Artifact 1.9.2
3024
3712
0
Artifact 1.9.3
3025
2176
1024
103
2018
1088
1536
2018
1152
1536
2018
1216
1536
2018
1280
1536
2018
1344
1536
2018
1408
1536
2018
1472
1536
2018
3136
1536
2018
3200
1536
2018
3264
1536
2018
3328
1536
2018
3392
1536
2018
3456
1536
2018
3520
1536
2018
3584
1536
2000
64
1344
2017
960
1472
2017
640
1152
2018
1472
1536
2018
1536
1536
2018
1600
1536
2018
1664
1536
2018
1728
1536
2018
1792
1536
2018
1856
1536
2018
1920
1536
2016
1984
1152
2015
1984
1024
2014
1984
960
2012
1984
1216
2012
1984
1280
2012
1984
1344
2012
1984
1344
2017
1984
512
2018
3072
1536
2014
1216
256
2016
1216
320
2016
896
192
2014
896
0
2014
896
128
2015
896
64
2012
2368
320
2012
2368
384
2016
2368
256
2014
1984
1088
2014
2368
192
2014
2368
128
2014
2368
64
2014
2368
0
2014
2560
0
2014
2560
64
2014
2560
128
2014
2560
192
2014
2560
256
2016
2560
320
2012
2560
384
2012
2560
448
2012
2560
512
2013
2624
768
2011
2304
832
2017
2752
256
2017
192
384
2013
3456
64
2013
3072
64
2011
3264
128
2014
3008
1216
2014
3008
1280
2016
3008
1344
2014
2240
896
2016
2240
960
2014
2240
1152
2016
2240
1216
2012
2240
1280
2012
2240
1344
2012
2240
1408
2016
2368
1088
2014
2368
1024
2015
2368
960
2014
2368
896
2013
2368
768
2003
64
384
2003
768
1152
2003
448
1472
2002
0
1472
2002
1344
896
2002
1664
576
2001
1600
576
2001
384
1472
2001
2112
832
2002
2048
832
2002
2880
832
2004
2560
1472
2002
2880
1472
2001
2624
1472
2017
3648
1472
2017
3776
64
2017
3008
576
2017
2304
1280
2001
2816
832
2005
1216
192
2003
3200
128
2003
3776
64
2758
3712
1408
