30
17
111111111111111111111111111111
000000000000000000000000000001
000000000000000000000000000001
000000000000000000000000000001
000000000000000000000000000001
000000000000000000000311111001
000000000000000000000100000001
000000000000000000001000000001
000101010000000000310000000001
000000000000000000100000000001
000000000000000001000000000001
000000000000000310000000000001
000003000000000100000000000001
001001000000001000000000000001
000000000000310000000000000001
000000000000100000000000000001
111111111111111111111111111111
0